19
    + + + + + + + + + + + + + + + + +
. . S                               +
. . .   + + + + + + + + + + + + +   +
. . .   +                       +   +
. . .   +   + + + + + + + + +   +   +
. . .   +   +               +   +   +
. . .   +   +   + + + + +   +   +   +
. . .   +   +   +       +   +   +   +
. . .   +   +   +   . . +   +   +   +
. . .   +   +   +   @ .     +   +   +
. . .   +   +   +           +   +   +
. . .   +   +   + + + + + + +   +   +
. . .   +   +                   +   +
. . .   +   + + + + + + + + + + +   +
. . .   +                           +
. . .   + + + + + + + + + + + + + + +
. . .
. . .
. . .